......~.......~......~...
......~.......~......~...
......~.......~......~...
......~.......~......~...
......~.......~..........
......~.......~..........
......~.......~..........
......~..................
......~..................
......~..................
......~..................
......~..................
......~..................
......~..................
......~..................
......~..................
......~..................
......~..................
......~..................
......~..................
......~..................
......~..................
......~..................
......~..................
.........................