.~.~.~..~...~....~....~..
.~.~.~..~...~....~....~..
.~.~.~..~...~....~....~..
.~.~.~..~...~....~....~..
.~.~.~..~...~....~.......
.~.~.~..~...~....~.......
.~.~.~..~...~............
.~.~.~..~...~............
.~.~.~..~................
.~.~.~..~................
.~.~.~...................
.~.~.~...................
.~.~.~...................
.~.~.~...................
.~.~.~...................
.~.~.~...................
.~.~.~...................
.~.~.~...................
.~.~.~...................
.~.~.~...................
.~.~.~...................
.~.~.~...................
.~.~.....................
.~.......................
.........................