
000000000000000
00000.....00000
000.o..„„.o.000
00.s..„P„„..s00
0...o..„„.....0
00.....▲▲..o.00
000...o.....000
0000...s...0000
000000000000000
